11111111111111111111111111111111111111
1C000C0F00C10C010C0000C1C000C000C000C1
10111111110101010110111111110111111101
1000100000010100001000C000000100000101
10101011110001110011110111110101110101
1C101C1000C101C1000000001C000001C101C1
10101011111101011111101011110100000101
1C10000001C10000C000C000C000C111110101
1010111101010111110111011101110C0F0101
100F100C0000000000000001C1000000001101
1010C011111101000P000100010101101110C1
1C1010C100C001000E0001C1C10100C00C0C11
10100000C101010000000101110101101110C1
1C11111111010100000001000C000C10001101
100000C00000C111111111011111100010C101
11110111111100000C0000C000001011101101
1C000C1C000C0C10111101011110100C0010C1
101110101111101C00C101000C101011101011
1000001010000011110101111000C0000C10C1
10101010C011001000F1010010111110111101
101F101010000000C100C000C000000F00C101
10101000111110111110101111110111110101
1C000C1C000C0000C000100C00C0000C0001C1
11111111111111111111111111111111111111