111111111111111111111111111111111111
1C00C0000000C00000C000000C00000000C1
101111110111110101111101110111101011
10C0000000C00000000C1000000C00000001
111101111101110111111101011111011101
1000C000C1P010000000E0000000C100C001
111111111110101111110111101011111111
10C000000100000000C00000001000000C01
101111010101111101101101111010111101
1000C000C00000C0000000000C0000000001
111111111111111111111111111111111111
