1111111111111111111
1P0000C000C00C00FC1
1011101110111011101
1C101C0010C010101C1
1000101110111C00101
1C0010C010C010001C1
100010111F111C00101
1C00C0000C000C000E1
1111111111111111111
